D5153D553
BFAFAFFFA
AFEF857FA
AFFFAFFFA
853FAFD52
812FAFFFA
C44545556

0,0
8,6
EEEESSSSSSEEEE
