951515553
AFAFAFFFA
AFEF857FA
AFFFAFFFA
817FAFD52
AC3FAFFFA
C7C545556

0,0
8,6
SSSSESESEEEEEE
